{
  "w": {
    "r": [6, 7, 8],
    "g": [0, 3, 6],
    "o": [2, 1, 0],
    "b": [8, 5, 2]
  },
  "r": {
    "y": [0, 1, 2],
    "g": [0, 1, 2],
    "w": [0, 1, 2],
    "b": [0, 1, 2]
  },
  "g": {
    "r": [8, 5, 2],
    "y": [0, 3, 6],
    "o": [8, 5, 2],
    "w": [8, 5, 2]
  },
  "o": {
    "w": [6, 7, 8],
    "g": [6, 7, 8],
    "y": [6, 7, 8],
    "b": [6, 7, 8]
  },
  "b": {
    "r": [0, 3, 6],
    "w": [0, 3, 6],
    "o": [0, 3, 6],
    "y": [8, 5, 2]
  },
  "y": {
    "r": [0, 1, 2],
    "b": [6, 3, 0],
    "o": [8, 7, 6],
    "g": [2, 5, 8]
  }
}